################
################
################
################
################
################
#ooa#
#ooo#
#ooo#
#####
3 1
